name	webPage	tox
Letter Particles	letter-particles-00	container_letter_particles
Blend CHOP 00	blend-chop-00	container_blend_chop-00
Blend CHOP and Spring SOP 00	blend-spring-chop-00	container_blend_spring_reset_00
Camera Animation 00	camera-animation-00	container_camera_animation-00
Camera Animation 01	camera-animation-01	container_camera_animation-01
Camera Animation 02	camera-animation-02	container_camera_animation-02
XML Creation Example	xml-example-00	container_xml_example_00
Write Vals to a Table	write-to-table-00	container_write_button_vals_to_table
Tabbed UI 00	ui-tab-selectable-00	container_tab_selectable_ui_00
Bin and Display	bin-and-display-00	container_bin_and_display_00
Waterfall	waterfall	container_waterfall
Simple Bouncing Ball	simple-bouncing-ball	container_simple_bouncing_ball
Display Break Up	display-break-up-00	container_display_breakup
Render Pick CHOP	render-pick-chop-00	container_render_pick_chop-00
Optimized Render System	optimized-render-system-00	container_optimized_render_system
Stoner Example	stoner-example-00	container_stoner_example_00
Kantan Example 	kantan-example-00	container_kantan_example_00
CamSchnappr Example 	camschnappr-example-00 	container_camschnappr_example_00
Spiralgraph		container_spiralgraph
